###########???##########
#                      #
#                      #
#                      #
#                      #
#                      #
#                      #
?                      ?
?                      ?
?                      ?
#                      #
#                      #
#                      #
#                      #
#                      #
#                      #
###########???##########
